1111111111111111
1C00011100000001
1000000000001111
1000P000000E0001
1000000000000001
1000C0C0C0000001
1110000000100001
1111111111111111