11111111111111111111111111
100000000000000C00000C0001
10100101001000001010010001
10100100101010100010010001
100000000C00C0000000000001
10000000000000000000000001
1000000000100000E000000001
10000000000100C00000000001
100000C0000010000000000001
10000000000000000000000001
1000000000000000000000C001
1P000000000000000000100001
10000000C11011000000000001
11111111111111111111111111
