1111111111
1000000001
1000000P01
10E0000001
1000000001
100000C001
1111111111
