111111111111111111111111
100000000000000000000001
100000000000000000000001
100000000000000000000001
100000000000000000000001
11P11111111C1111E1111111
111111111111111111111111
